1111111111111111111111111111
1000000000001000000000000001
1000000E11000000000011100001
10010000C000000000000C10C001
10010000P1000100100111100001
10001111110100000001CC100001
1001100000000100C001CC100001
100110000C01010000010010C001
1001100CC0000001100000000C01
1001100000000111100001111001
1001100111010000000000000001
1001100000000001111110000001
1001100C00010000000000000C01
10011000C0010000C00000000001
1111111111111111111111111111